overweight - избыточный вес
fat - жирный 
slim - стройный 
young - молодой 
old - старый 
years old - лет 
about 25 - около 25 лет 
in his(her) forties - в свои сорок лет 
beautiful / pretty (women) - красивая / привлекательная (женщина) 
handsome (men) - красивый / привлекательный (мужчина) 
sun-tanned - загорелый 
pale - бледный 
attractive - привлекательный 
good-looking - хорошо выглядящий 
cute - милый 
nice - приятный 
plain - обычный 
plain-looking - не привлекательный 
unattractive - непривлекательный 
ugly - уродливый 
I have / You have / He has / She has (got) … blue / green / grey / brown eyes - у меня / у тебя / у него / у нее есть голубые / зеленые / серые / коричневые глаза 
freckles - веснушки 
a beard - борода 
a full beard - длинная борода 
a moustache - усы 
a goatee - козлиная бородка 
a stubbly beard - щетина на лице 
blond hair - блондинистые волосы 
red hair - рыжие волосы 
brown hair - коричневые волосы 
black hair - черные волосы 
dyed hair - окрашенные волосы 
blond highlights - светлые пряди 
short hair - короткие волосы 
long hair - длинные волосы 
straight hair - прямые волосы 
curly hair / curls - кудрявые волосы / кудри 
a bald head - лысая голова 
a square / round / triangular / oval face - квадратное / круглое / треугольное / овальное лицо 
a big / small / long nose - большой / маленький / длинный нос 
big / small ears - большие / маленькие уши 
I wear / You wear / He wears / She wears … glasses - я ношу / ты носишь / он носит / она носит очки contact 
lenses - контактные линзы 
earrings - серьги 
a necklace - ожерелье 
a wristband - браслет на запястье 
a bracelet - браслет на руке 
jeans - джинсы 
a tie - галстук
middle-aged man. - мужчина средних лет.
Positive - Позитивный 
warm and friendly - теплый и дружелюбный 
kind - добрый nice
pleasant - приятный, приятный в общении 
generous - щедрый (= рад давать / делиться) 
optimistic - оптимистичный (= думает положительно) 
Negative - Негативный 
cold and unfriendly - холодный и недружелюбный 
unkind - недобрый 
horrible, unpleasant - ужасный, неприятный 
mean (= never gives to others) - жадный (= никогда не дает другим) 
pessimistic (= thinks negatively) - пессимистичный (= думает отрицательно)
cheerful - веселый
miserable - несчастный
relaxed and easy-going - расслабленный и легкомысленный
tense - напряженный
strong - сильный
weak - слабый
sensitive - чувствительный
insensitive - безразличный
honest - честный
dishonest - нечестный
hard-working - трудолюбивый
lazy - ленивый
punctual - пунктуальный
not very punctual - непунктуальный
reliable - надежный
unreliable - ненадежный
clever, bright (infml) - умный, яркий (разг.)
stupid, thick (infml) - глупый, близкий (разг.)
flexible - гибкий
inflexible - негибкий
ambitious - амбициозный
unambitious - неамбициозный
shy - застенчивый
self-confident - уверенный в себе
reserved - сдержанный
emotional - эмоциональный
uses her initiative - использует свою инициативу
has got no common sense - не имеет здравого смысла
sensible - разумный
tense - напряженный
relaxed - расслабленный
easy-going - легко общающийся
cheerful - веселый
optimistic - оптимистичный
warm - добрый, теплый
kind - добрый
insensitive - безразличный
honest - честный
husband - муж
wife - жена
spouse - супруг
father - отец
mother - мать
parents - родители
son - сын
daughter - дочь
child - ребенок
children - дитя
brother - брат
sister - сестра
siblings - близнецы
twins - близняшки	
grandfather - дедушка
grandmother - бабушка
grandparents -  бабушка с дедушкой
grandson - внук
granddaughter - внучка
grandchild - внук
grandchildren - внучата
great-grand - пра-бабушка и child внук
stepfather - отчим
stepmother - мачеха
сводный(я) - stepbrother –брат
stepsister - сестра
half-brother/half-sister - (единокровные: брат/сестра по одному родителю)
adopted - приемный
adopted son - приемный сын
adopted daughter - приемная дочь
adopted child - приемный ребенок
foster - приемная(ый/ые)
foster family - приемная семья
foster father - приемный отец
foster mother - приемная мать
foster parents - приемные родители
foster son - приемный сын
foster daughter - дочь
foster child - ребенок
uncle - дядя
aunt - тетя 
nephew - племянник
niece - племянница 
Cousin - двоюродный брат
first cousin - двоюродный брат
second cousin - (троюродный (ая)); 
close relatives - близкие родственнники 
distant relatives - дальние родственники 
my family - моя семья
my relatives - мои родственники 
my folks - мои предки
my kin - моя родня 
in-laws - родня со стороны мужа или жены
father-in-law - тесть 
mother-in-law - теща 
son-in-law - зять
sons-in-law - зятья
daughter-in-law - сноха
daughters-in-law - снохи
brother-in-law - шурин
brothers-in-law - шурины
sister-in-law - свояченица
sisters-in-law - свояченицы 
child - ребенок
baby - дитя 
infant - младенец 
teenager - подросток 
adolescent - тинейджер 
adult - взрослый
grownup - взрослый
young man - юноша 
young woman - девушка 
old man - старик
old woman - старушка
single - одинокий
married - женатый
engaged - обрученный
separated - разведен 
divorced - разведен
widower - вдовец
widow - вдова 
fiancé - жених
engagement - обручиться
engagement ring - обручальное кольцо 
bride - невеста
bridegroom - жених
wedding - свадьба 
Divorce - развод
ex-husband - бывший муж
ex-wife - бывашая жена 
alimony - алименты
child support - алименты
girlfriend - девушка
boyfriend - парень 
lover - любовник
paramour - любовница
beau - франт
mistress - хозяйка
pregnancy - беременность
birth - рождение
the baby is due in June - ребенок должен родиться в июне
child care - уход за детьми
kindergarten - детский сад
babysitter - няня