overweight - избыточный вес
about 25 - около 25 лет 
in his(her) forties - в свои сорок лет 
beautiful / pretty (women) - красивая / привлекательная (женщина) 
handsome (men) - красивый / привлекательный (мужчина) 
sun-tanned - загорелый 
pale - бледный 
attractive - привлекательный 
nice - приятный 
plain-looking - не привлекательный 
unattractive - непривлекательный 
I have / You have / He has / She has (got) … blue / green / grey / brown eyes - у меня / у тебя / у него / у нее есть голубые / зеленые / серые / коричневые глаза 
freckles - веснушки 
a beard - борода 
a full beard - длинная борода 
a moustache - усы 
a goatee - козлиная бородка 
a stubbly beard - щетина на лице 
dyed hair - окрашенные волосы 
curly hair / curls - кудрявые волосы / кудри 
a bald head - лысая голова 
a square / round / triangular / oval face - квадратное / круглое / треугольное / овальное лицо 
I wear / You wear / He wears / She wears … glasses - я ношу / ты носишь / он носит / она носит очки contact 
lenses - контактные линзы 
earrings - серьги 
a necklace - ожерелье 
a wristband - браслет на запястье 
a bracelet - браслет на руке 
a tie - галстук
middle-aged man. - мужчина средних лет.
pleasant - приятный, приятный в общении 
generous - щедрый (= рад давать / делиться) 
optimistic - оптимистичный
cold and unfriendly - холодный и недружелюбный 
horrible, unpleasant - ужасный, неприятный 
mean (= never gives to others) - жадный (= никогда не дает другим) 
pessimistic (= thinks negatively) - пессимистичный (= думает отрицательно)
cheerful - веселый
miserable - несчастный
relaxed and easy-going - расслабленный и легкомысленный
tense - напряженный
sensitive - чувствительный
insensitive - безразличный
hard-working - трудолюбивый
not very punctual - непунктуальный
reliable - надежный
unreliable - ненадежный
clever, bright (infml) - умный, яркий (разг.)
stupid, thick (infml) - глупый, близкий (разг.)
flexible - гибкий
inflexible - негибкий
self-confident - уверенный в себе
reserved - сдержанный
uses her initiative - использует свою инициативу
has got no common sense - не имеет здравого смысла
sensible - разумный
relaxed - расслабленный
easy-going - легко общающийся
warm - добрый, теплый
husband - муж
spouse - супруг
siblings - близнецы
grandchild - внук
grandchildren - внучата
great-grand - пра-бабушка и child внук
stepfather - отчим
stepbrother – сводный брат
stepsister - сводная сестра
half-brother/half-sister - (единокровные: брат/сестра по одному родителю)
adopted - приемный
foster parents - приемные родители
foster daughter - дочь
foster child - ребенок
uncle - дядя
aunt - тетя 
nephew - племянник
niece - племянница 
Cousin - двоюродный брат
first cousin - двоюродный брат
second cousin - троюродный брат; 
close relatives - близкие родственнники 
distant relatives - дальние родственники 
my folks - мои предки
in-laws - родня со стороны мужа или жены
son-in-law - зять
baby - дитя 
infant - младенец 
teenager - подросток 
adolescent - тинейджер 
grownup - взрослый
young man - юноша 
young woman - девушка 
married - женатый
engaged - обрученный
separated - разведен 
widower - вдовец
fiancé - жених
engagement - обручиться
bride - невеста
bridegroom - жених
wedding - свадьба 
Divorce - развод
ex-husband - бывший муж
alimony - алименты
girlfriend - девушка
lover - любовник
paramour - любовница
mistress - хозяйка
pregnancy - беременность
the baby is due in June - ребенок должен родиться в июне
child care - уход за детьми
kindergarten - детский сад
babysitter - няня