colleague - коллега
to get on very well - хорошо ладить
to get rid of - избавиться
openness - открытость 
honest - честный
value - ценность 
to share - делить, разделять (например, ценности, взгляды)
to count - считать, полагать
quality of relationships - качество отношений
to improve - улучшать
to erode (over time) - разрушаться (с течением времени)
to make sense - иметь смысл
to maintain - поддерживать, сохранять
maintenance - поддержка, сохранение
in order to - для того, чтобы
to lure - привлекать, заманивать
to accrue - накапливать
to hinge - зависеть
to strive - бороться, стараться
to matter - значить, иметь значение
downtime - свободное время
personal fulfilment - реализация своих способностей, самореализация
recreation - отдых, восстановление сил, развлечение
to pursue - заниматься чем-либо
to appreciate - ценить
passion - страсть, страстное увлечение
exciting - волнующий, увлекательный, захватывающий
fascinating - захватывающий, увлекательный
purpose - цель, намерение
to contribute to - вносить вклад, содействовать
to engage - заниматься чем-либо, быть занятым чем-либо
to interfere with - мешать, быть помехой
to perform -  выполнять, делать
to boost  - поднимать, поддерживать, повышать
to thrive - процветать, преуспевать
to unwind [ai] - расслабляться, отдыхать
to wonder ['wʌndə] - удивляться, интересоваться
to wander ['wɔndə] - бродить, блуждать
to rejuvenate [rɪ'ʤuːv(ə)neɪt] -  восстанавливать, омолаживать
