Friendship - дружба
close friend - близкий друг
classmate - одноклассник
colleague - коллега
healthy friendship - здоровая дружба
toxic friendship - токсичная дружба
to have a lot in common - иметь много общего
to get on very well - хорошо ладить
to keep in touch - поддерживать отношения, связь
to get in touch - связаться связываться
to get rid of - избавиться
to lose touch - потерять связь
soul - душа
freedom - свобода
mutual trust - взаимное доверие
openness - открытость 
affection - привязанность
honest - честный
value - ценность 
to value - ценить
to share - делить, разделять (например, ценности, взгляды)
to argue - спорить
to count - считать, полагать
to count on - рассчитывать на
to respect - уважать
to nurture - питать, взращивать, выращивать
boundaries - границы
social media - социальные сети
quality of relationships - качество отношений
effort - попытка
to improve - улучшать
to hurt - причинять вред, ущерб; портить
to erode (over time) - разрушаться (с течением времени)
social ties - социальные связи
to make sense - иметь смысл
self-disclosure - самораскрытие
IRL friends - In Real Life friends
online pals - онлайн приятели, друзья
shallow - мелкий, поверхностный
to maintain - поддерживать, сохранять
maintenance - поддержка, сохранение
dormant - спящий, дремлющий, находящийся в спячке, нереализованный
lifespan - продолжительность, срок жизнь
in order to - для того, чтобы
rather than - а не 
to lure - привлекать, заманивать
to accrue - накапливать
to hinge - зависеть
to strive - бороться, стараться
to matter - значить, иметь значение
leisure - свободное время, досуг 
free time - свободное время
spare time - свободное время
downtime - свободное время
time off - свободное время
pastime -  времяпрепровождение, приятное занятие, развлечение, увеселение; игра
personal fulfilment - реализация своих способностей, самореализация
recreation - отдых, восстановление сил, развлечение
to recover - восстанавливаться
to pursue - заниматься чем-либо
to appreciate - ценить
passion - страсть, страстное увлечение
exciting - волнующий, увлекательный, захватывающий
fascinating - захватывающий, увлекательный
inspiring - вдохновляющий
disappointing - разочаровывающий
boring - скучный, наводящий скуку
tiring - утомительный
purpose - цель, намерение
to contribute to - вносить вклад, содействовать
to engage - заниматься чем-либо, быть занятым чем-либо
to interfere with - мешать, быть помехой
to perform -  выполнять, делать
to boost  - поднимать, поддерживать, повышать
to thrive - процветать, преуспевать
to counteract - противодействовать, препятствовать
exhaustion - истощение
to exhaust - истощать, изнурять, исчерпывать
to unwind [ai] - расслабляться, отдыхать
to wonder ['wʌndə] - удивляться, интересоваться
to wander ['wɔndə] - бродить, блуждать
to rejuvenate [rɪ'ʤuːv(ə)neɪt] -  восстанавливать, омолаживать
